1111111111
100C000001
1P00011C01
100C01E001
1111111111