1111111111
100000E001
1P00000E01
100000PP01
1111111111