1111111111111111111111111
1000000000000C00000C10011
1000000E010000C1110000001
1000000P011110000C1100001
1111111111111111111111111