1111111111
100C000001
1P00000001
100C000001
1111111111