1111111111
1010010001
100C011011
1100001101
10000E0C01
1000000111
1000C00101
1101C11001
100010C001
10C1000C01
1C00C01P01
10C000C101
1111111111