11111111111
100C0000001
1P00011C001
100C01E0001
11111111111