11111111111111111111111111111111111
1000000000000C00000C100100000000001
1000000E010000C11100000000000000001
1000000P011110000C11000000000000001
11111111111111111111111111111111111