11111111111
1PE00000001
10000000001
10000000001
11111111111