11111111111
1PC00000001
100E0011101
1000001C101
11111111111