11111111111
1PC00000001
10000011101
1000001E101
11111111111