11111111111
10EC0000001
10000000001
10000000001
11111111111