111111111111
100C00000011P
100000000011
100000000011
111111111111